0 0 0 0 0 0 5 5 0 0 0 0 0 0 0 0 6 6 0 0 0 0 0 0 0 0 
0 0 0 0 0 0 5 5 0 0 0 0 0 0 0 0 6 6 0 0 0 0 0 0 0 0 
6 6 6 6 0 0 5 5 0 0 6 6 6 6 6 6 6 6 0 0 5 5 5 5 5 5 
6 6 6 6 0 0 5 5 0 0 6 6 6 6 6 6 6 6 0 0 5 5 5 5 5 5 
2 0 2 0 3 3 0 0 0 0 3 3 0 0 0 0 6 6 0 0 5 5 2 0 5 5 
0 0 0 0 3 3 0 0 0 0 3 3 0 0 0 0 6 6 0 0 5 5 0 0 5 5 
2 0 5 5 5 5 5 5 5 5 0 0 4 4 0 0 0 0 3 3 2 0 2 0 2 0 
0 0 5 5 5 5 5 5 5 5 0 0 4 4 0 0 0 0 3 3 0 0 0 0 0 0 
2 0 2 0 0 0 5 5 0 0 0 0 6 6 0 0 6 6 6 6 6 6 6 6 2 0 
0 0 0 0 0 0 5 5 0 0 0 0 6 6 0 0 6 6 6 6 6 6 6 6 0 0 
6 6 6 6 0 0 5 5 0 0 6 6 6 6 0 0 0 0 6 6 0 0 0 0 0 0 
6 6 6 6 0 0 5 5 0 0 6 6 6 6 0 0 0 0 6 6 0 0 0 0 0 0 
0 0 0 0 3 3 2 0 3 3 0 0 3 3 2 0 0 0 6 6 0 0 0 0 5 5 
0 0 0 0 3 3 0 0 3 3 0 0 3 3 0 0 0 0 6 6 0 0 0 0 5 5 
0 0 6 6 6 6 2 0 5 5 5 5 5 5 5 5 0 0 2 0 3 3 0 0 5 5 
0 0 6 6 6 6 0 0 5 5 5 5 5 5 5 5 0 0 0 0 3 3 0 0 5 5 
3 3 0 0 0 0 3 3 0 0 0 0 5 5 0 0 2 0 2 0 6 6 0 0 5 5 
3 3 0 0 0 0 3 3 0 0 0 0 5 5 0 0 0 0 0 0 6 6 0 0 5 5 
5 5 5 5 0 0 6 6 6 6 0 0 5 5 3 3 6 6 6 6 6 6 0 0 0 0 
5 5 5 5 0 0 6 6 6 6 0 0 5 5 3 3 6 6 6 6 6 6 0 0 0 0 
0 0 0 0 3 3 0 0 2 0 2 0 0 0 0 0 2 0 6 6 0 0 0 0 6 6 
0 0 0 0 3 3 0 0 0 0 0 0 0 0 0 0 0 0 6 6 0 0 0 0 6 6 
0 0 5 5 5 5 5 5 2 0 0 0 0 0 0 0 0 0 6 6 0 0 6 6 6 6 
0 0 5 5 5 5 5 5 0 0 0 3 3 3 3 0 0 0 6 6 0 0 6 6 6 6 
0 0 5 5 0 0 0 0 0 0 0 3 7 0 3 0 0 0 0 0 0 0 0 0 0 0 
0 0 5 5 0 0 0 0 0 0 0 3 0 0 3 0 0 0 0 0 0 0 0 0 0 0 